ryan,100,100
0,0,1,0,0,0,2,0,0,0,0,0,0,2,0,0,0,2,0,0,0,0,0,0,3,1,0,0,0,3,0,0,0,0,0,1,0,0,0,0,1,0,0,0,2,1,0,0,1,0,4,1,0,1,0,2,0,2,0,0,2,1,0,0,2,1,0,0,0,1,0,2,0,0,0,0,0,1,0,0,0,2,1,1,1,1,0,2,0,0,0,0,0,1,0,1,2,0,0,2
0,0,0,1,0,0,0,0,0,0,0,0,0,0,0,1,0,0,2,0,1,0,0,0,0,0,0,1,0,0,0,0,1,0,0,4,0,0,0,0,0,0,0,0,0,4,1,2,0,0,0,0,0,1,0,0,0,1,1,0,2,0,0,0,1,1,0,0,0,0,0,1,0,1,0,1,0,2,0,0,1,0,2,2,0,1,0,0,1,1,0,0,0,1,0,0,0,2,1,0
0,0,0,1,0,3,2,1,0,0,0,2,0,1,2,1,0,0,0,1,0,0,0,0,0,1,0,1,1,0,0,0,0,1,0,1,0,0,1,0,0,0,0,0,0,0,1,0,2,1,0,0,0,0,1,1,0,0,0,0,0,0,0,0,0,0,0,0,2,0,0,0,0,0,3,0,5,0,1,0,0,2,1,1,2,0,0,0,0,1,0,0,2,0,0,0,2,1,2,0
0,0,0,0,0,0,1,0,0,0,2,0,0,1,0,0,0,0,0,3,0,1,0,0,0,1,0,0,0,1,0,1,0,2,1,2,0,0,4,4,1,2,0,0,0,0,1,0,0,0,3,0,1,1,0,0,2,0,0,0,0,0,1,0,0,2,0,1,0,0,0,2,0,0,0,0,0,2,0,0,1,0,1,1,0,0,0,1,0,2,3,0,0,0,2,0,0,2,0,0
0,0,0,0,0,0,0,1,1,0,0,0,1,0,0,0,0,0,1,0,0,1,0,0,0,0,0,0,2,0,0,0,4,2,0,3,0,1,2,0,0,0,1,2,1,0,0,1,1,0,1,1,0,0,0,0,1,0,0,2,1,1,0,1,0,1,0,1,0,0,0,1,0,0,0,1,0,1,1,0,0,0,2,3,2,0,0,1,1,1,0,0,0,0,0,3,1,0,4,0
0,1,0,0,0,1,1,0,0,0,0,2,0,0,2,3,0,1,1,0,0,0,2,0,0,0,0,4,2,0,1,0,0,0,0,0,2,0,4,3,1,1,0,1,0,0,2,0,1,0,1,1,0,0,0,0,0,0,0,2,0,0,4,0,0,1,0,0,0,1,0,1,0,0,2,2,0,0,0,1,1,1,0,0,0,2,2,0,2,0,0,0,3,0,0,3,0,1,1,0
0,0,3,0,0,0,0,1,1,1,4,0,2,2,1,0,3,0,0,0,1,1,0,0,0,0,1,0,2,0,0,0,0,0,0,0,1,0,1,0,0,0,0,0,0,1,0,0,0,0,1,0,1,0,0,0,0,0,1,0,0,0,2,4,0,0,0,0,0,0,0,1,1,0,0,2,0,0,0,0,0,0,0,0,0,4,0,0,2,0,0,0,0,0,0,0,1,0,0,2
0,1,0,1,0,1,0,0,0,0,1,1,0,0,0,1,0,0,0,0,0,1,0,1,0,0,2,0,0,0,0,0,1,0,0,0,1,0,1,0,1,0,1,1,0,2,0,0,0,0,1,0,0,0,0,0,1,0,0,0,0,0,0,1,4,0,0,2,1,0,1,0,0,0,0,0,1,1,0,0,0,0,0,0,0,0,0,0,2,0,1,0,1,3,3,0,3,1,0,0
1,0,0,1,0,0,0,0,0,1,0,0,0,0,3,1,0,1,0,1,0,1,0,1,0,0,1,0,0,2,0,0,0,0,1,0,0,0,0,1,1,0,0,0,0,0,0,0,1,0,0,0,0,2,2,0,0,2,0,0,0,0,1,1,0,0,0,0,0,4,0,0,0,1,0,1,0,0,0,0,1,0,0,0,0,0,0,0,0,0,0,0,0,0,0,2,3,0,1,2
0,0,0,0,0,0,0,1,0,0,0,0,0,1,0,0,0,0,0,1,0,0,1,0,1,0,0,3,0,0,1,0,0,0,0,0,0,0,1,0,0,1,0,0,1,0,0,0,0,0,1,0,2,2,0,2,0,0,0,0,2,0,0,0,1,0,1,0,0,0,0,0,0,2,0,0,0,0,1,0,0,2,0,0,0,0,3,0,1,0,0,1,0,2,0,0,0,0,1,2
0,2,0,0,1,2,0,2,0,0,0,0,0,0,0,0,0,3,2,0,0,0,2,1,0,0,0,0,0,0,1,0,0,1,0,0,0,2,0,1,0,0,2,3,0,1,2,0,1,0,0,0,0,0,0,1,0,0,0,0,0,0,0,0,0,3,1,0,0,0,0,0,0,2,1,4,0,0,0,0,0,1,2,0,1,0,0,0,2,0,0,1,0,1,0,0,0,0,1,1
0,0,0,2,0,0,1,0,0,0,0,0,0,2,0,2,0,0,1,1,0,0,1,0,0,0,2,1,0,1,0,0,1,0,4,0,0,0,0,0,0,1,0,1,3,0,0,0,0,0,0,2,1,0,0,0,1,0,0,0,1,0,0,0,0,0,0,0,0,0,0,2,0,0,0,0,0,0,0,1,1,0,0,0,4,0,1,0,0,0,0,0,0,1,0,0,0,0,4,0
0,0,1,0,0,0,0,0,0,0,0,0,1,0,0,1,1,0,0,0,0,0,1,0,0,0,1,0,0,1,0,1,0,1,0,2,1,0,0,1,0,3,0,0,2,2,0,0,0,0,1,0,1,2,0,0,1,2,0,1,0,0,0,0,0,1,0,0,0,0,0,0,1,0,2,0,0,1,0,0,0,0,0,0,1,1,0,0,1,0,1,0,1,0,3,2,0,1,0,0
0,4,0,0,1,0,3,0,0,2,0,0,0,0,0,0,2,0,0,0,1,0,0,0,0,5,0,0,1,2,0,0,0,0,0,0,0,0,0,0,0,0,0,0,0,0,0,0,0,1,0,1,2,1,0,0,1,1,0,0,0,0,0,4,0,0,0,0,0,1,1,0,0,0,1,0,2,0,0,0,0,0,0,1,1,1,0,0,1,0,0,0,0,0,1,2,0,2,0,0
0,1,0,0,0,0,0,0,0,1,2,1,1,0,0,0,0,0,1,0,1,0,3,0,1,0,1,0,0,0,0,0,1,2,0,0,0,0,0,0,0,0,0,0,0,0,1,1,0,0,2,0,0,1,0,0,0,0,2,0,0,1,0,1,1,4,0,2,0,0,0,3,0,2,2,0,1,1,1,0,0,0,0,0,0,0,0,1,0,2,0,0,1,1,0,1,0,1,0,2
0,0,2,0,1,1,0,0,0,1,5,2,2,0,0,0,0,2,0,0,1,0,0,0,0,1,0,0,0,0,0,1,0,0,0,0,0,2,0,2,0,2,0,0,0,0,0,0,0,1,0,2,0,0,0,1,0,0,0,0,0,1,0,0,3,0,1,0,1,4,0,0,1,0,0,1,0,1,2,0,0,0,0,0,0,0,0,0,1,1,0,1,0,3,0,0,0,0,1,0
0,0,0,1,0,0,0,0,0,0,1,0,1,0,0,1,0,2,0,0,1,2,0,0,0,1,3,0,0,0,0,0,0,2,2,0,0,0,0,0,1,0,0,0,0,0,0,0,3,0,0,0,0,0,1,0,0,4,0,0,0,3,0,0,0,0,0,0,0,1,0,1,0,0,0,1,1,0,1,0,0,0,2,0,0,0,0,0,4,0,0,0,0,2,0,0,1,4,0,0
0,1,1,1,1,1,0,1,0,0,0,0,0,1,0,0,0,0,0,0,0,3,1,1,0,0,1,1,1,0,0,1,0,1,0,0,4,0,0,1,0,1,0,1,0,0,4,2,0,0,1,1,2,0,1,0,0,2,1,0,0,0,0,0,0,1,1,2,0,0,0,0,1,3,0,2,0,0,0,0,0,0,1,1,0,1,0,0,3,0,0,0,0,0,0,0,3,1,0,1
1,1,0,0,0,0,0,1,1,0,0,0,0,0,1,0,0,0,0,1,0,0,1,0,5,1,0,2,1,0,0,0,3,1,0,0,0,0,0,0,0,2,1,0,0,0,3,0,4,0,0,0,0,0,0,0,0,0,0,0,0,0,0,0,1,0,0,1,0,0,1,0,0,0,0,0,0,0,0,2,1,1,0,2,0,0,0,0,0,0,0,0,4,0,1,0,0,1,0,1
0,1,0,0,3,0,0,7,2,1,1,0,0,0,1,0,1,1,1,1,0,0,1,1,0,1,1,0,0,1,0,0,0,0,1,3,1,0,0,2,0,2,0,0,0,0,2,0,1,0,0,0,0,2,2,0,1,0,1,2,0,0,0,0,0,0,0,0,0,0,1,0,1,0,1,0,0,0,0,0,0,0,1,0,0,0,0,1,0,3,0,0,1,0,0,1,0,0,0,0
0,0,0,1,0,2,0,0,0,0,0,0,0,0,0,0,0,0,0,1,0,2,0,0,1,1,0,0,0,2,1,0,0,0,2,0,1,0,0,0,0,0,0,1,0,0,0,0,1,0,0,0,0,0,0,0,0,0,0,1,0,0,0,0,0,0,1,0,0,0,1,2,0,0,0,0,1,0,0,0,0,0,3,0,0,2,2,1,1,0,1,0,0,0,0,1,1,1,1,0
0,0,0,0,1,0,1,0,0,0,0,0,0,0,1,1,1,0,0,0,1,0,0,0,0,1,0,0,1,0,0,0,0,0,0,0,0,3,1,0,0,0,1,0,0,1,0,0,0,0,0,0,0,0,0,2,0,0,1,0,0,1,0,0,0,0,0,0,0,1,1,0,1,1,1,0,1,0,0,4,0,1,0,3,0,2,0,0,1,1,0,0,0,0,0,0,0,0,0,0
0,0,0,1,0,1,0,0,2,3,1,0,0,1,0,1,1,0,0,1,0,0,0,1,0,0,0,1,0,0,1,2,0,1,0,1,2,0,0,0,4,0,0,0,1,1,2,0,0,0,0,0,1,0,1,0,1,0,1,0,2,1,0,0,0,2,0,0,2,1,0,1,1,1,0,0,1,0,0,1,0,0,0,0,0,0,0,0,0,2,0,0,0,0,0,2,0,0,0,0
0,1,0,2,0,0,0,1,0,0,1,1,0,0,0,0,0,0,0,0,2,0,1,0,1,0,1,0,1,0,0,0,1,0,0,1,0,1,0,2,1,3,1,1,0,0,1,0,1,2,1,0,0,0,4,0,0,0,1,0,0,0,3,2,0,3,0,0,3,1,0,0,1,2,2,1,0,3,0,1,0,0,0,0,1,1,0,0,0,1,0,0,0,0,0,0,0,1,0,1
0,3,3,0,1,0,0,0,1,0,0,0,0,0,1,0,1,0,0,1,0,0,1,2,0,1,0,0,0,0,0,0,0,0,0,2,0,0,0,1,0,0,0,1,3,0,0,0,0,1,0,0,2,1,0,0,0,0,1,0,1,1,0,0,0,0,0,0,1,0,2,0,1,0,0,0,0,1,0,0,0,0,2,0,1,1,0,0,1,1,0,4,0,0,0,3,0,0,0,0
0,0,1,0,0,1,0,1,0,0,0,2,2,2,0,0,3,0,0,0,1,0,0,0,0,0,0,0,1,0,0,0,0,1,0,1,0,1,0,1,3,1,1,0,3,0,0,0,2,0,1,0,0,0,0,0,0,3,0,2,0,1,2,3,0,1,0,0,1,0,0,2,0,0,0,1,1,0,0,0,1,0,0,0,1,0,0,0,0,0,1,0,0,2,0,0,0,0,0,2
0,0,0,0,0,0,1,2,0,1,0,0,0,0,1,0,0,0,0,1,1,1,2,0,0,0,0,0,1,0,0,0,0,1,0,0,0,0,0,3,0,0,1,1,0,2,0,0,4,1,1,0,0,0,0,2,0,1,2,0,0,0,1,0,2,0,1,0,0,1,0,0,2,0,0,0,1,0,0,0,1,0,0,0,1,0,0,1,0,1,1,0,0,0,0,1,1,1,2,1
1,0,0,0,1,0,0,0,1,1,0,0,1,1,0,0,0,0,0,1,2,0,0,0,0,3,0,1,0,0,0,1,0,1,0,1,0,0,1,2,0,1,0,0,0,0,0,0,0,0,0,1,2,0,0,1,0,0,0,2,1,2,1,0,0,0,0,0,0,2,0,1,0,0,0,1,1,0,0,2,1,0,1,0,1,0,2,0,0,0,0,2,0,1,0,0,0,0,0,0
0,0,2,0,1,0,0,0,1,0,0,1,5,0,1,0,1,0,1,0,0,0,0,0,1,0,1,0,0,1,0,0,1,0,1,0,0,0,0,0,0,1,0,0,0,0,0,2,0,0,0,0,0,0,1,1,0,0,0,0,2,0,0,0,0,0,0,0,1,0,0,1,1,1,0,0,0,0,0,0,0,0,0,1,0,0,0,0,1,0,0,0,0,0,0,1,0,0,0,0
0,0,0,0,0,0,0,0,0,0,0,0,1,1,0,0,2,0,0,1,2,0,0,0,1,1,0,0,1,0,2,2,0,4,0,1,0,1,0,0,0,0,0,0,2,1,0,1,0,0,3,0,0,0,0,0,0,1,0,0,0,0,0,0,0,0,2,1,2,0,0,2,0,0,0,2,1,0,1,0,0,0,0,0,0,1,0,0,1,2,1,0,0,1,3,0,0,0,0,0
0,0,0,1,1,0,0,0,0,0,1,0,2,0,0,1,1,0,0,0,1,0,0,1,0,0,0,0,0,1,0,0,0,0,0,1,2,0,0,1,0,0,3,0,2,0,2,0,0,0,0,0,1,0,0,0,0,0,1,0,1,0,1,2,1,3,1,0,2,1,0,0,0,2,0,0,0,0,0,1,0,0,3,3,0,0,1,0,1,1,0,2,0,0,0,1,1,0,0,0
1,0,2,2,0,0,0,0,0,0,1,2,1,0,0,1,0,0,0,0,0,0,0,0,0,0,3,1,0,0,0,1,0,2,2,1,0,1,0,0,0,0,0,1,1,1,0,1,0,1,0,2,0,0,0,0,2,0,0,0,0,0,0,1,1,3,0,0,0,0,0,1,1,0,0,0,1,0,1,0,0,0,2,0,2,0,1,0,1,0,2,3,0,0,0,0,0,3,3,0
2,0,0,0,0,0,1,1,2,0,0,1,2,1,2,0,2,0,2,0,0,0,0,0,0,0,1,0,0,1,1,0,0,0,0,1,1,0,0,0,0,0,0,0,0,1,0,0,2,1,0,1,1,0,0,0,2,0,1,0,0,0,0,0,2,1,0,1,0,0,0,0,0,0,0,0,1,1,0,0,0,0,1,3,0,2,0,1,0,0,0,0,0,0,3,1,2,0,0,0
1,0,1,5,1,0,0,1,0,0,1,1,0,0,2,1,1,0,0,0,0,0,0,0,1,1,0,3,0,1,0,1,0,0,0,0,0,0,0,0,2,0,0,1,2,0,2,1,0,0,0,0,0,0,0,1,0,0,1,0,1,1,0,0,0,1,1,4,2,0,0,2,0,4,1,0,3,0,0,2,0,0,0,0,1,2,2,0,0,0,0,1,3,1,1,0,0,0,1,0
0,0,0,1,0,1,0,0,3,1,0,1,0,0,1,0,0,2,2,0,1,1,0,1,0,0,0,4,0,0,0,0,0,0,0,0,0,0,1,0,2,0,0,1,0,0,0,1,0,0,0,0,0,0,0,0,1,0,1,0,1,0,0,0,1,0,0,0,0,2,0,0,2,3,0,3,0,0,0,0,0,2,0,0,2,1,0,0,1,0,0,0,0,0,0,0,0,0,0,1
0,0,2,0,1,4,1,1,0,0,0,0,0,0,0,1,1,0,0,0,1,0,0,0,1,0,1,1,0,0,2,0,3,1,1,2,0,0,0,0,0,0,0,0,0,0,2,0,0,3,0,0,1,0,1,0,1,0,0,0,0,0,0,4,0,0,4,1,0,0,1,0,0,1,0,0,0,0,1,2,0,0,0,0,0,2,0,0,1,1,1,1,0,0,0,0,1,1,1,1
1,1,0,0,1,0,3,3,1,0,1,0,0,0,0,0,0,1,0,2,1,0,0,0,0,0,0,0,2,1,1,0,0,1,0,0,0,1,0,0,2,0,0,0,1,0,0,2,0,0,4,0,0,0,0,0,0,0,1,0,1,1,0,0,0,2,0,0,0,1,1,0,0,0,0,0,0,0,0,1,2,0,1,0,0,1,5,2,1,0,1,1,1,0,1,1,4,0,0,0
2,1,2,0,0,0,1,1,0,1,0,0,0,0,0,1,0,0,0,1,1,0,0,0,4,1,2,0,0,0,0,0,0,0,0,0,0,1,0,0,0,0,0,1,0,0,1,0,0,0,0,0,0,1,0,0,0,0,0,0,0,0,0,0,0,0,0,0,0,1,0,2,2,0,0,0,1,2,0,1,0,0,1,1,3,0,2,1,1,0,0,1,0,0,2,0,0,2,0,0
0,1,0,1,1,0,2,1,0,0,0,1,1,0,1,0,1,0,0,0,1,0,4,0,0,0,1,0,0,0,0,0,0,1,0,1,0,0,1,0,1,1,0,3,0,2,0,1,0,0,1,0,0,0,2,0,0,0,0,0,0,0,0,0,0,1,0,0,0,1,1,1,1,1,0,1,0,2,0,0,0,0,0,1,0,0,1,1,2,2,1,1,0,0,0,1,0,0,0,0
4,1,2,0,0,0,1,1,0,0,0,1,1,0,0,2,0,0,2,0,0,0,1,1,0,0,0,1,0,0,0,1,0,1,0,0,1,0,3,0,1,3,2,0,1,1,2,0,0,0,1,1,0,0,0,0,0,2,1,0,0,2,0,0,2,1,0,0,1,1,0,3,1,0,0,0,0,0,1,0,0,1,1,0,1,1,0,0,0,0,0,1,0,0,2,0,2,0,0,1
0,0,0,0,0,1,0,0,0,0,0,2,2,0,0,1,0,0,0,0,1,0,2,0,0,2,0,1,1,0,0,0,0,0,0,0,0,1,1,0,3,0,0,0,2,1,1,0,0,0,1,1,0,0,1,2,0,0,1,2,0,0,0,0,0,1,0,1,3,0,1,0,0,0,2,0,0,0,0,0,0,0,0,3,2,0,0,0,0,0,2,1,0,1,0,1,0,3,1,1
0,2,1,0,1,0,0,0,0,0,1,1,2,2,0,2,0,0,0,0,0,0,1,0,1,1,1,2,0,0,2,2,0,0,1,0,0,0,0,0,0,0,0,1,1,0,0,0,0,0,2,0,0,1,0,1,0,1,1,0,0,1,0,0,3,0,0,0,0,0,0,0,0,0,2,1,1,3,0,0,0,0,0,0,2,1,0,1,1,0,0,0,1,0,1,0,1,2,0,1
0,0,0,0,1,0,1,0,0,1,4,0,0,0,0,0,1,0,0,0,0,0,0,1,1,0,1,1,0,0,0,0,0,0,2,0,0,0,0,0,0,0,0,0,0,0,1,1,1,2,2,0,0,0,0,0,1,0,0,0,0,0,0,0,0,1,1,0,1,1,0,1,1,0,0,1,0,1,0,0,1,0,2,0,0,0,1,0,0,0,2,0,0,1,1,3,0,0,0,0
1,2,0,0,0,0,0,1,0,0,0,0,2,0,1,0,1,1,0,0,0,0,0,1,0,0,0,0,0,0,0,0,0,0,1,2,0,0,0,0,0,0,0,0,0,0,2,0,1,2,0,0,0,1,0,1,0,3,1,0,0,2,0,0,1,0,0,0,0,2,0,0,1,0,0,0,0,0,0,0,0,0,1,0,0,0,0,0,1,0,0,0,0,0,1,0,0,0,0,0
1,1,0,0,0,1,0,2,0,0,0,3,0,0,1,0,0,0,0,0,0,0,0,0,0,0,0,0,0,0,0,0,0,0,0,0,0,0,0,0,0,0,0,0,0,0,0,0,0,1,0,1,2,0,0,0,1,1,0,0,0,0,2,0,2,0,0,0,1,0,0,3,0,0,1,0,1,0,0,0,1,1,0,1,0,2,0,3,1,1,1,1,0,0,2,0,0,1,0,0
0,3,0,0,1,0,0,0,1,0,0,0,1,1,2,0,0,0,0,0,0,0,1,0,0,0,0,0,0,0,0,0,0,0,0,0,0,0,0,0,0,0,0,0,0,0,0,0,0,0,0,0,0,0,0,0,0,0,0,0,0,0,0,0,0,0,0,0,0,5,0,0,1,0,0,0,2,0,0,1,1,0,2,0,1,1,0,0,1,2,0,0,0,0,0,0,0,0,0,0
3,0,1,1,2,0,2,0,0,0,0,0,0,0,2,0,1,0,0,0,1,0,0,1,0,0,0,0,0,0,0,0,0,0,0,0,0,0,0,0,0,0,0,0,0,0,0,0,0,0,0,0,0,0,0,0,0,0,0,0,0,0,0,0,0,0,0,0,0,0,1,1,3,1,1,0,0,3,0,1,2,0,0,0,0,0,1,1,0,0,0,1,0,0,0,2,0,0,1,0
0,0,1,0,0,0,1,0,0,0,1,0,2,0,0,1,0,1,2,0,2,0,0,0,0,0,0,0,0,0,0,0,0,0,0,0,0,0,0,0,0,0,0,0,0,0,0,0,0,0,0,0,0,0,0,0,0,0,0,0,0,0,0,0,0,0,0,0,0,0,0,0,0,1,2,0,0,2,2,0,2,0,0,0,0,0,0,0,1,0,2,1,0,0,0,0,0,0,0,0
0,0,0,0,0,0,0,0,0,0,0,1,1,0,2,0,0,2,3,0,2,1,0,0,0,0,0,0,0,0,0,0,0,0,0,0,0,0,0,0,0,0,0,0,0,0,0,0,0,0,0,0,0,0,0,0,0,0,0,0,0,0,0,0,0,0,0,0,0,0,0,0,0,0,1,0,0,0,1,1,0,0,1,0,0,0,0,0,1,0,0,3,0,0,0,0,0,0,0,0
0,3,1,3,1,0,0,1,1,0,0,0,1,0,0,0,1,0,1,1,0,0,0,0,0,0,0,0,0,0,0,0,0,0,0,0,0,0,0,0,0,0,0,0,0,0,0,0,0,0,0,0,0,0,0,0,0,0,0,0,0,0,0,0,0,0,0,0,0,0,0,0,0,0,0,0,0,0,0,0,0,2,0,0,1,0,0,0,0,0,0,0,1,0,0,0,0,0,0,0
0,0,0,0,0,3,0,0,1,0,0,1,0,1,0,0,0,0,0,0,0,2,1,0,0,0,0,0,0,0,0,0,0,0,0,0,0,0,0,0,0,0,0,0,0,0,0,0,0,0,0,0,0,0,0,0,0,0,0,0,0,0,0,0,0,0,0,0,0,0,0,0,0,0,0,0,0,0,0,0,0,0,0,0,0,0,0,0,0,0,0,1,1,2,1,2,0,0,0,1
1,0,0,0,2,0,0,2,0,0,0,0,0,0,0,1,0,0,1,1,0,0,0,0,0,2,0,0,1,0,0,0,0,0,0,0,0,0,0,0,0,0,0,0,0,0,0,0,0,0,0,0,0,0,0,0,0,0,0,0,0,0,0,0,0,0,0,0,0,0,0,0,0,0,0,0,0,0,0,0,0,1,0,0,0,0,0,2,0,0,1,0,0,1,1,1,2,0,0,2
1,0,0,1,0,1,0,2,0,0,0,1,0,0,0,0,1,0,0,0,0,2,0,0,0,0,0,1,1,1,0,0,0,0,0,0,0,0,0,0,0,0,0,0,0,0,0,0,0,0,0,0,0,0,0,0,0,0,0,0,0,0,0,0,0,0,0,0,0,0,0,0,0,0,0,0,0,0,0,0,0,1,1,0,0,0,0,0,0,1,0,3,0,0,0,0,1,1,0,2
1,0,1,1,0,0,0,0,1,0,1,0,0,0,1,0,0,1,0,0,0,0,0,1,0,0,1,0,2,0,0,0,0,0,0,0,0,0,0,0,0,0,0,0,0,0,0,0,0,0,0,0,0,0,0,0,0,0,0,0,0,0,0,0,0,0,0,0,0,0,0,0,0,0,0,0,0,0,0,0,0,1,0,1,0,1,0,0,1,0,0,1,0,1,1,0,0,0,3,0
0,0,0,0,2,0,0,0,0,1,1,1,0,0,0,0,0,0,3,0,0,0,2,0,0,0,0,0,0,0,0,0,0,0,0,0,0,0,0,0,0,0,0,0,0,0,0,0,0,0,0,0,0,0,1,1,0,0,0,0,0,0,0,0,0,0,0,0,0,0,0,0,0,0,0,0,0,0,0,2,1,0,0,0,0,0,1,1,1,2,0,2,0,0,2,1,3,0,0,1
0,0,0,0,0,0,0,0,0,0,0,5,1,1,0,1,0,0,0,0,0,0,0,0,0,0,0,0,0,0,0,0,0,0,0,0,0,0,0,0,0,0,0,0,0,0,0,0,0,0,0,0,2,0,0,2,0,0,1,0,0,1,2,0,0,0,0,1,0,0,0,0,0,0,0,0,0,0,0,0,0,0,0,2,1,1,1,1,1,0,1,1,0,0,2,0,0,2,0,1
0,1,0,0,0,0,0,1,1,0,0,0,0,0,0,1,0,0,0,0,0,0,0,0,0,0,0,0,0,0,0,0,0,0,0,0,0,0,0,0,0,0,0,0,0,1,0,0,0,0,0,0,1,1,0,1,0,1,0,0,0,0,0,0,1,2,0,0,0,0,0,0,0,0,0,0,0,0,1,0,0,2,0,0,0,0,1,2,1,0,0,0,0,0,1,0,0,0,4,0
1,0,0,0,1,0,0,1,0,1,0,1,0,0,1,0,0,0,0,0,0,0,0,0,0,0,0,0,0,0,0,0,0,0,0,0,0,0,0,0,0,0,0,0,0,1,1,0,0,0,0,0,2,0,0,3,0,4,0,1,2,0,2,2,0,1,2,0,0,0,0,0,0,0,2,0,0,0,0,0,0,0,0,0,1,3,0,0,0,0,0,0,0,0,0,1,0,0,0,0
0,0,0,0,0,0,1,0,0,0,0,0,0,0,0,0,0,0,0,0,0,0,0,0,0,0,0,0,0,0,0,0,0,0,0,0,0,0,0,0,0,0,0,0,0,0,0,0,0,0,0,0,0,2,0,0,0,0,0,0,1,0,0,0,0,0,0,0,0,0,0,0,1,0,0,1,0,0,0,1,0,0,1,0,2,0,0,4,0,2,2,0,0,0,1,1,1,1,3,1
0,0,0,0,0,0,0,0,0,0,0,0,0,0,0,0,0,0,0,0,0,0,0,0,0,0,0,0,0,0,0,0,0,0,0,0,0,0,0,0,0,0,0,0,0,0,0,0,0,0,0,0,0,0,0,0,0,0,0,0,0,1,0,0,0,0,0,0,0,3,1,2,0,1,0,0,2,0,0,0,0,0,0,0,0,2,1,1,1,0,1,0,0,0,1,1,0,0,0,2
0,0,0,0,0,0,0,0,0,0,0,0,0,0,0,0,0,0,0,0,0,0,4,255,2,256,0,0,20,37,20,21,11,0,24,17,24,17,241,0,0,0,0,0,0,0,0,0,0,0,0,0,0,0,0,0,0,0,0,0,0,0,1,0,0,0,0,0,0,0,0,0,0,5,1,0,0,1,1,0,0,0,0,1,0,3,0,0,0,0,0,0,0,0,0,0,2,0,1,3
0,0,0,0,0,0,0,0,0,0,0,0,0,0,0,0,0,0,0,0,0,0,0,0,0,0,0,0,0,0,0,0,0,0,0,0,0,0,0,0,0,0,0,0,0,0,0,0,0,0,0,0,0,0,0,0,0,0,0,0,0,0,0,0,1,0,1,0,0,0,1,0,2,0,0,0,4,0,0,1,0,0,2,1,0,0,0,0,0,0,0,0,0,3,0,0,1,0,1,0
0,0,0,0,0,0,0,0,0,0,0,0,0,0,0,0,0,0,0,0,0,0,0,0,0,0,0,0,0,0,0,0,0,0,39,21,21,20,0,6,9,0,0,0,0,0,0,0,0,0,0,0,0,0,0,0,0,0,0,0,0,0,0,0,0,0,0,0,0,0,0,0,0,0,0,0,0,0,0,0,0,0,0,0,0,0,0,0,0,0,0,0,0,0,0,1,3,2,0,0
0,0,0,0,0,0,0,0,0,0,0,0,0,0,0,0,0,0,0,0,0,0,0,0,0,0,0,0,0,0,0,0,0,0,0,0,0,0,0,0,0,0,0,0,0,0,0,0,0,0,0,0,0,0,0,0,0,0,0,0,0,0,0,0,0,0,0,0,0,0,0,0,0,0,0,0,0,0,0,0,0,0,0,0,0,0,0,0,0,0,0,3,1,0,2,0,0,2,0,1
0,0,0,0,0,0,0,0,0,0,0,0,0,0,0,0,0,0,0,0,0,0,0,0,0,0,0,0,0,0,0,0,0,0,0,0,0,0,0,0,0,0,0,0,0,0,0,0,0,0,0,0,0,0,0,0,0,0,0,0,0,0,0,0,0,0,0,0,0,0,0,0,0,0,0,0,0,0,0,0,0,0,0,0,0,0,0,0,0,0,3,0,0,1,3,0,0,0,1,0
0,0,0,0,0,0,0,0,0,0,0,0,0,0,0,0,0,0,0,0,1,0,0,0,0,1,2,0,0,2,0,0,0,0,0,0,0,0,0,0,0,0,0,0,0,0,0,0,0,0,0,0,0,0,0,0,0,0,0,0,0,0,0,0,0,0,0,0,0,0,0,0,0,0,0,0,0,0,0,0,0,0,0,0,0,0,0,0,0,0,0,3,0,0,1,0,0,0,0,1
0,0,0,0,0,0,0,0,0,0,0,1,0,0,2,0,2,0,1,0,0,0,0,1,1,0,0,0,0,1,0,0,0,0,0,0,0,0,0,0,0,0,0,0,0,0,0,0,0,0,0,0,0,0,0,0,0,0,0,0,0,0,0,0,0,0,0,0,0,0,0,0,0,0,0,0,0,0,0,0,0,0,0,0,0,0,0,0,0,0,0,0,0,0,0,0,0,0,1,2
0,0,0,2,1,0,1,0,1,3,0,0,0,0,0,0,0,0,0,0,0,0,0,0,0,1,1,1,1,0,0,1,0,0,0,0,0,0,0,0,0,0,0,0,0,0,0,0,0,0,0,0,0,0,0,0,0,0,0,0,0,0,0,0,0,0,0,0,0,0,0,0,0,0,0,0,0,0,0,0,0,0,0,0,0,0,0,0,0,0,0,0,0,2,1,0,0,0,0,0
0,0,0,0,0,0,0,0,0,0,0,0,0,1,0,0,0,0,0,0,0,0,0,3,0,2,0,0,0,2,0,1,0,0,0,0,0,0,0,0,0,0,0,0,0,0,0,0,0,0,0,0,0,0,0,0,0,0,0,0,0,0,0,0,0,0,0,0,0,0,0,0,0,0,0,0,0,0,0,0,1,1,1,0,0,0,0,1,0,1,0,1,0,3,0,0,1,1,0,0
0,0,0,0,0,0,0,0,0,0,0,0,0,1,0,0,0,0,0,0,0,0,0,0,0,1,0,1,1,0,0,2,0,0,0,0,0,0,0,0,0,0,0,0,0,0,0,0,0,0,0,0,0,0,0,0,0,0,0,0,0,0,0,0,0,0,0,0,0,0,0,0,0,0,0,0,0,0,0,0,0,0,2,1,0,0,1,0,0,0,1,0,1,2,0,1,0,0,0,3
0,0,0,0,0,0,0,0,0,0,0,0,0,0,0,0,0,0,0,0,0,0,0,1,0,2,0,2,0,0,1,0,0,0,0,0,3,0,0,0,0,0,0,0,0,0,0,0,0,0,0,0,0,0,0,0,0,0,0,0,0,0,0,0,0,0,0,0,0,0,0,0,0,0,0,0,0,0,0,0,0,0,0,2,0,2,1,0,0,2,0,0,1,0,0,1,0,2,0,0
0,0,0,0,0,0,0,0,0,0,0,0,0,0,0,0,0,0,0,0,0,0,0,0,0,0,0,0,0,0,0,0,0,0,0,0,0,0,0,0,0,0,0,0,0,0,0,0,0,0,0,0,0,0,0,0,0,0,0,0,0,0,0,0,0,0,0,0,0,0,0,0,0,0,0,0,0,0,0,4,0,0,0,1,0,0,0,2,0,0,1,1,0,3,2,1,0,1,0,0
0,0,0,0,0,0,0,0,0,0,0,0,0,0,0,0,0,0,0,0,0,0,0,0,0,1,0,0,0,0,1,0,0,0,0,0,0,0,0,0,0,1,0,0,0,0,0,0,0,0,0,0,0,0,0,0,0,0,0,0,0,0,0,0,0,0,0,0,0,0,0,0,0,3,0,1,0,0,2,0,0,0,1,0,0,3,0,0,3,1,2,1,0,0,0,1,0,1,0,1
0,0,0,0,0,0,0,0,0,0,0,0,0,0,0,0,0,0,0,0,0,0,0,0,0,0,0,0,0,0,0,0,0,0,0,2,0,0,1,0,0,2,0,0,0,0,0,0,0,0,0,0,0,0,0,0,0,0,0,0,0,0,0,0,0,0,0,0,0,0,0,0,0,1,0,0,0,0,0,1,0,0,0,0,0,0,0,0,0,0,0,0,0,0,0,0,0,0,0,0
0,0,3,0,0,0,0,0,0,0,0,0,0,0,0,0,0,0,0,0,0,0,0,0,0,0,0,0,0,0,0,0,0,0,0,0,0,0,0,0,0,0,0,0,0,0,0,0,0,0,0,0,0,0,0,0,0,0,0,0,0,0,0,0,0,0,0,0,0,0,0,0,0,0,0,0,0,0,0,0,0,0,0,0,0,0,0,0,0,0,0,0,0,0,0,0,0,0,0,0
0,1,2,5,0,0,0,0,0,0,0,0,0,0,0,0,0,0,0,0,0,0,0,0,0,0,0,0,0,1,0,0,0,1,3,0,0,0,0,0,0,0,3,0,2,0,1,0,0,0,0,0,0,1,1,0,0,2,0,0,1,1,0,1,1,0,1,0,3,1,0,0,1,0,2,1,0,0,0,0,2,1,0,1,0,0,0,3,0,0,0,0,2,0,0,1,0,0,0,1
0,0,0,0,0,0,0,0,0,0,0,0,0,0,0,0,0,0,0,0,0,0,1,0,0,0,0,3,0,0,0,0,0,0,0,0,0,0,0,1,0,0,0,1,2,0,2,0,0,3,0,1,0,0,0,0,0,0,1,1,0,2,0,1,0,1,0,1,0,1,0,0,1,0,0,0,0,1,0,0,0,1,2,1,0,0,0,0,0,0,0,2,0,1,0,1,1,0,0,3
1,0,0,0,0,0,0,0,0,0,0,0,0,0,0,0,0,0,0,0,0,0,1,0,1,0,0,0,0,1,1,0,0,0,2,1,0,1,1,0,0,1,0,1,3,4,0,0,0,0,2,2,0,0,0,1,0,0,0,1,0,0,1,0,0,0,0,3,0,6,0,1,0,0,0,0,1,0,0,1,0,0,0,0,0,0,0,0,2,0,0,1,0,0,0,0,0,0,3,0
0,0,0,0,0,0,0,0,0,0,0,0,0,0,0,0,0,0,0,0,0,0,0,0,0,0,0,1,2,1,0,2,1,0,0,0,0,0,0,0,0,0,0,0,0,0,0,0,0,0,1,0,0,0,0,3,0,1,0,0,0,0,1,0,0,0,0,0,2,0,0,0,0,2,0,1,0,0,5,0,0,0,1,1,1,3,2,0,0,0,0,0,0,0,2,2,1,0,1,1
0,0,0,0,0,0,0,0,0,0,0,0,0,0,0,0,0,0,0,0,0,0,0,3,0,0,2,4,1,2,1,0,0,0,0,0,0,0,0,0,0,1,0,0,0,0,0,0,0,1,1,1,0,0,0,0,2,0,0,0,1,0,2,0,1,0,0,0,1,2,0,0,0,0,0,0,3,1,1,0,1,1,0,0,0,0,0,0,0,0,0,1,1,3,0,0,1,3,0,1
0,0,0,0,0,1,0,0,0,2,0,0,0,0,0,0,0,0,0,0,0,0,0,1,1,1,0,1,0,1,0,5,0,0,0,0,0,0,0,0,0,1,0,1,0,0,0,0,1,0,0,1,1,3,0,0,0,0,1,0,0,0,0,0,0,0,2,1,3,0,0,0,0,2,2,0,0,1,0,1,1,3,1,0,3,0,0,6,0,1,2,1,1,0,0,0,0,0,0,0
1,0,0,0,0,0,0,2,7,1,3,1,0,0,0,0,1,1,0,1,2,0,0,0,1,1,1,0,0,1,3,3,1,0,0,0,3,0,0,0,0,0,3,1,1,0,1,0,0,0,0,1,1,0,0,1,0,0,3,0,1,0,0,0,1,0,0,0,1,0,3,0,2,0,1,0,1,7,0,2,2,1,2,0,2,0,0,0,1,0,1,1,0,0,0,0,0,2,1,0
0,0,0,2,0,0,1,1,0,0,1,0,1,1,0,0,0,0,0,1,0,0,0,4,1,0,0,0,2,0,1,0,1,0,0,0,0,0,0,0,0,0,0,0,0,0,1,0,0,0,1,1,2,3,0,0,0,2,0,0,2,0,1,0,1,0,0,0,0,1,0,1,2,0,0,2,0,0,0,1,0,4,0,0,0,0,0,1,0,1,2,0,0,1,0,0,3,0,0,1
0,0,1,1,1,0,1,0,0,0,0,0,1,0,0,1,1,0,1,0,0,0,0,0,0,0,0,0,0,0,0,1,0,0,0,2,0,2,1,3,0,0,0,0,2,0,0,1,0,1,0,0,0,1,0,0,1,0,0,0,1,0,1,0,1,0,0,1,0,1,1,0,0,2,0,0,0,0,0,0,1,0,0,0,0,0,4,0,0,2,0,0,0,0,0,0,0,0,1,2
0,1,0,0,3,0,0,0,4,0,0,0,1,1,1,0,0,0,0,0,0,0,0,2,2,0,0,0,1,0,0,2,0,0,0,0,0,0,0,0,2,0,0,0,0,1,0,0,0,0,0,0,0,0,2,0,0,2,0,0,0,0,1,2,0,2,0,0,0,0,0,0,0,0,0,0,0,0,1,0,0,0,0,0,1,1,0,1,1,0,0,0,1,0,0,0,0,1,0,0
0,0,2,0,1,2,0,0,1,0,1,0,0,1,0,2,1,0,0,0,0,0,0,1,0,1,0,0,0,0,1,0,1,1,1,1,0,1,0,0,0,0,0,0,0,0,0,2,0,0,0,0,0,0,0,4,0,0,2,0,0,1,5,0,2,1,5,1,2,1,1,1,3,2,0,3,0,0,1,2,1,0,1,0,1,0,1,0,0,0,3,0,2,0,4,0,0,0,0,0
0,0,3,1,0,1,0,0,0,0,0,0,0,0,0,2,0,1,2,0,0,0,0,0,0,0,0,0,3,0,1,1,1,0,1,0,0,0,1,1,1,0,0,0,0,0,0,0,0,0,0,0,0,1,0,0,0,2,1,1,0,1,0,0,1,0,0,0,0,0,0,0,0,1,1,0,0,0,0,0,0,0,1,2,1,1,0,0,0,0,0,2,2,0,0,0,0,0,0,0
1,0,0,0,3,1,3,0,0,0,0,2,0,0,1,0,0,1,0,0,1,0,1,0,1,0,0,0,2,0,2,0,0,1,0,0,0,0,0,1,0,1,1,0,1,0,1,0,1,0,0,4,0,0,0,0,3,0,0,1,0,1,0,0,0,0,0,0,0,0,0,0,0,0,1,0,0,0,0,0,0,0,0,0,0,0,0,0,3,0,0,0,0,0,0,1,0,0,0,0
0,0,0,0,0,0,1,0,1,0,0,1,1,1,0,0,1,0,1,0,0,0,0,0,0,0,1,2,0,0,2,1,0,2,0,0,0,1,0,0,0,0,0,0,0,0,0,0,0,0,0,0,0,1,0,2,0,0,2,0,0,1,0,0,0,2,0,0,0,0,0,1,1,0,0,1,0,0,0,0,0,1,1,0,2,0,1,2,0,0,0,0,0,0,0,0,0,2,3,0
1,0,0,0,0,2,0,0,0,0,0,0,0,0,0,1,0,1,0,0,2,1,1,0,0,0,1,0,0,4,3,0,0,0,1,1,2,0,0,1,1,0,0,2,0,1,0,0,1,0,0,0,2,1,0,1,0,1,2,0,1,2,0,0,2,1,0,0,4,0,0,1,0,0,0,0,0,0,0,0,0,0,2,0,0,0,0,0,0,0,0,0,1,2,0,0,0,1,0,0
0,0,2,1,0,0,0,0,0,0,2,2,0,0,0,0,0,1,2,1,1,1,1,0,2,1,0,0,1,0,1,3,0,7,1,1,1,2,2,0,1,0,0,0,0,0,0,1,0,1,1,0,0,1,1,0,2,0,0,0,0,1,2,0,2,2,1,0,0,0,2,0,0,0,0,0,0,0,1,0,0,1,0,0,0,0,0,1,0,0,1,1,0,3,0,0,0,0,0,0
0,0,0,0,0,2,0,0,2,0,0,0,2,0,0,0,1,0,0,1,0,1,1,0,0,0,0,0,0,2,0,0,0,2,1,0,2,0,0,2,0,0,0,0,0,0,1,0,2,1,0,2,0,2,3,0,2,1,1,2,1,4,0,0,0,3,0,1,0,0,0,0,0,0,1,0,0,1,0,0,0,0,2,1,1,0,2,0,0,0,0,0,0,2,1,0,0,0,1,0
1,0,0,0,0,0,0,0,0,1,1,1,0,1,0,0,0,0,0,2,1,0,0,0,0,0,1,0,4,1,1,1,0,0,0,0,1,0,2,0,0,0,0,0,1,0,0,1,0,4,6,0,1,0,0,2,0,0,2,0,2,1,1,1,0,0,0,0,0,0,1,1,2,2,2,0,1,0,0,0,0,0,0,0,1,0,0,3,0,0,0,0,0,0,0,0,0,0,0,2
0,1,1,1,0,0,0,0,0,0,1,0,0,0,0,0,1,0,0,2,0,0,2,1,0,0,0,0,0,0,0,0,0,0,0,2,0,0,0,0,1,0,0,2,2,0,0,0,3,0,0,1,2,0,1,0,2,0,0,4,0,0,0,0,1,1,0,1,1,0,0,0,4,0,1,0,1,1,0,0,1,0,1,1,0,0,0,2,0,0,0,0,0,0,0,0,0,3,0,0
0,0,0,0,1,0,2,0,0,0,0,1,2,1,0,1,0,1,1,0,0,1,1,0,0,0,0,0,1,0,0,1,0,0,0,1,0,0,0,1,1,0,1,0,0,0,1,0,0,2,1,0,2,1,0,0,0,1,0,2,0,1,0,1,0,1,0,0,1,0,2,0,2,1,0,0,0,0,1,1,1,0,0,0,0,1,0,0,0,0,0,1,0,6,0,0,1,2,1,1
1,0,0,1,0,0,1,1,0,0,0,0,0,0,0,0,1,0,0,4,0,0,0,1,0,0,1,0,1,1,0,0,0,1,3,1,2,1,0,0,0,0,2,0,1,0,1,0,0,0,1,2,1,1,2,1,1,0,1,0,1,0,0,0,0,1,1,0,0,0,0,0,0,2,1,0,0,0,0,0,0,0,0,1,0,1,0,0,1,0,0,0,0,2,0,0,0,0,0,0
1,1,0,0,0,0,0,0,0,0,1,2,1,1,0,0,1,0,0,0,1,0,0,0,3,0,0,0,0,0,0,2,0,0,5,2,0,0,0,3,1,0,1,0,0,1,1,0,1,1,0,0,0,1,0,1,1,0,0,0,0,2,0,2,1,2,0,0,1,3,1,0,0,1,0,0,1,1,0,3,3,0,0,0,0,1,0,2,0,0,1,0,1,0,0,0,0,0,1,0
0,0,0,0,0,0,0,0,0,1,0,0,1,1,2,1,0,0,1,0,0,2,0,0,1,0,1,0,0,0,0,0,0,0,0,0,2,0,1,1,3,1,1,0,0,0,0,0,0,1,0,0,1,0,0,0,0,0,0,0,1,0,1,1,0,0,0,0,0,1,1,0,0,2,0,2,0,0,2,0,1,0,0,4,0,0,0,1,0,1,0,0,0,0,0,1,0,0,0,0
1,0,0,1,0,1,1,0,1,1,2,0,0,1,0,2,0,2,0,0,0,0,0,0,1,0,0,0,1,0,0,0,0,0,0,0,1,1,0,1,1,0,0,5,1,1,0,1,1,0,1,0,1,1,0,0,0,1,0,2,1,0,0,0,2,0,0,0,0,1,2,0,0,2,0,0,0,0,2,0,0,0,0,2,0,0,0,0,0,0,1,0,2,1,2,0,0,0,1,0
0,0,0,2,0,0,0,0,1,0,0,1,0,0,0,0,0,0,0,0,0,0,0,1,0,1,0,0,2,0,0,0,0,0,0,1,0,1,0,3,0,1,0,0,0,1,0,0,1,0,0,0,0,0,2,0,0,0,0,0,0,0,1,4,1,0,1,0,1,0,0,1,0,0,0,0,1,0,2,0,1,1,2,0,0,1,0,0,0,0,1,0,0,1,2,0,0,1,0,3
